NO cub3d-tester/textures/wall.xpm
SO cub3d-tester/textures/bricks.xpm
WE cub3d-tester/textures/gold.xpm
EA cub3d-tester/textures/wood.xpm
S cub3d-tester/textures/enemy.xpm
F 220,111,119
C 225,111,0

          
1111111
110N91
111111