R  1500 1000

NO assets/north100x.xpm
SO assets/south100x.xpm
WE assets/west100x.xpm
EA assets/east100x.xpm

C  179, 229, 227
 
F 175, 161, 165

11111111111
10101000001
10000000001
10000000001
10000000001
10000E00001
10100000001
10010000011
11111111111
