R  1500 1000

NO assets/posters.xpm
SO assets/mountains1.xpm
WE assets/border.xpm






EA assets/opt1-copy.xpm


C  179,       229, 227 
F 175, 161, 165
1111111111111
1000000110001
1000E00000001
1000111000001
1000001000001
1111111111111

