R  1500 1000

NO assets/north100x.xpm
SO assets/south100x.xpm
WE assets/west100x.xpm
EA assets/east100x.xpm

C  179, 229, 227
 
F 175, 161, 165
1111111111111
1000001000001
1000000000001
1000000000001
100S000000001
1000000000001
1000000000001
1000000000001
1111111111111
