R  1500 1000

//NO assets/posters.xpm
//SO assets/mountains1.xpm
//WE assets/border.xpm
//EA assets/opt1-copy.xpm

NO assets/north100x.xpm
SO assets/south100x.xpm
WE assets/east100x.xpm
EA assets/east100x.xpm

C  179, 229, 227
 
F 175, 161, 165
11111111111
10000000001
100E0000001
10000000001
10000000001
11111111111

