R  1500 1000

NO      texture/room2.xpm
SO texture/room4.xpm
WE texture/room3.xpm
EA texture/room1.xpm
S  texture/alpaca.xpm

C     239,  167,47
F 93,60,45

1111111111
1000000001
1000000001
10E0000001
1000000001
1000000001
1000000001
1111111111

