R  1500 1000

NO      texture/room2.xpm
SO texture/room4.xpm
WE texture/room3.xpm
EA texture/room1.xpm
S  texture/alpaca.xpm

C     239,  167,47
F 93,60,45

111111111
100000001
1000E0001
111111111
