R  1500 1000

NO      texture/room2.xpm
SO texture/room4.xpm
WE texture/room3.xpm
EA texture/room1.xpm
S  texture/alpaca.xpm

C  179, 229, 227
 
F 175, 161, 165

1111111
1010101
1000001
10000E1
1010001
1001011
1111111
